    ####
 ####  #
## $   #
#  # #$#
#.@..  ##
## # #. #
 #   $  #
 #  #####
 ####