####
#  ###
#    ##
# .#$ #
## @  #
 #.#$##
 #   #
 #####