  #####
###   #
# $ # ##
# #  . #
## #   #
 #@  ###
 #####