   ####
####  #
# $ $ #
#  .# ##
## #.  #
# @  $ #
#.  ####
#####