  ####
###  ###
#   *$ #
# #  #@#
# # *. #
#   ####
#####