####
#  ####
#     #
#     #
### ###
# $$  ##
# . .@ #
####   #
   #####