 #####
 #  ####
 #     #
 # #.  #
##*##$##
#    * #
# # @  #
#    ###
######