  #####
  #+  ###
 ##*# $ #
 # *    #
## * # ##
#  *   #
#   ####
#####