     ####
  ####  #
  #..   #
### $@# ##
#  $ #.. #
# $   $  #
####  ####
   ####