  #####
 ##   ###
 #      #
 #*#*#* #
 # #@$ ##
## # #.#
#      #
#   #  #
######## 