  ####
###  ###
#   .  #
#  $ $ #
##.#+#.#
 # $ $ #
 ###  ##
   ####