######
#    ##
#  *  #
# $*$ #
## * ##
 # * #
 # . #
 ##+##
  ###