 #####
##   ###
# ...* #
# #@$# #
# $    #
### #$##
  #   #
  #####