   ####
 ###  #
## @$ #
# .$  #
# .*  ##
# .$ #
##  ##
 ####