      ####
####### .#
# $ $ $$ #
#   @ ...#
###   ####
  #####