  #####
###   ##
#  $#  #
#  .@.$##
##.# #  #
 # $    #
 ##  ####
  ####