    #####
#####   ##
#   #$#  #
#   $.@# #
## ##..  #
#  #.  ###
#  $ $ #
#  #####
####